alreadyConnected=节点已经连接
containsValidationErrors=包含效验错误
updatingDocument=更新文档。请等候......
updatingSelection=更新所选项。请等候......
collapse-expand=折叠/展开
doubleClickOrientation=双击以改变方向
close=关闭
error=错误
done=完成
cancel=取消
ok=确定
isCollaborationNode=多人协作:
deadline=办理时限:
mSelectType=主办人员：
label=名称
height=高度
width=宽度
href=链接
joinType=汇聚类型:
splitType=分支类型:
splitTypeAnd=并行分支
splitTypeOR=串行分支
joinTypeAnd=并行汇聚
joinTypeOR=串行汇聚
numberofJoinvotes=汇聚票数
orderOfCollaboration=按顺序会签
orderOfStepExecution=节点顺序
stepDefaultSelectParticipator=默认选中所有人员
stepCcNotHandleParticipator=抄送选中未办人员
removeExecutedParticipator=过滤已办理过的人员
stepTypeCode=节点类型
stepTypeCode0=审批
stepTypeCode1=提交
stepTypeCode2=查阅